retina|iraten
create|aceter
linear|anelir
nature|enuart
tailor|latori
region|gerion
window|dinwow
eating|aitgen
ignore|ergoni
senior|inorse
regain|aireng
earing|ierang
donate|adtone
editor|detrio
reason|aneros
tattoo|atotto
python|phtony
gerbil|begirl
proton|ontopr
twelve|lewvet
velvet|elevtv
clutch|cuthcl
burgle|belrug
lizard|azilrd
castle|acslet
guitar|aritug
sphere|ersehp
defect|ctfeed
frozen|ofrezn
gadget|tagged
rabbit|britba
regret|errteg
dragon|agndro
trades|aderst
weaver|arvewe
badger|adberg
evaded|addeve
carved|adervc
target|aergtt
thread|ardthe
savage|avegsa
abacus|asacub
better|tbtree
scared|arcsed
friend|drefin
august|gutsau
battle|abeltt
richer|cheirr
forget|ergoft
beware|baerwe
